1010010110101111
1000101000010100
0001000010101100
0111010010100001
0110001000001000
1000100111000010
1001011010000000
1010010110101111
1000101000010100
0001000010101100
0111010010100001
0110001000001000
1000100111000010
1001011010000000
1000100111000010
1001011010000000
